4 13 31
###############################
#p    * **    *   3   4       #
# # # #*# # # # # # # # # # # #
#      ** f *  *   * ** 3 *   #
# # # # # #*# # # # # # #*# # #
#*   * * 5  *b* *   **        #
# # # # # # # # # # # # # #*# #
#    *     *        *    **  3#
# #s# # #*#*#*#*# # #1# # #*# #
#        * 4 *2*    *   *     #
#*# # # # # # # # # # #*# # #*#
#x*    * **    ** ***     1   #
###############################



