3 13 31
###############################
#p   ** **    *   2           #
# # # #*# # # # # # # # # # # #
#*     ** * *  *   * ** 3 *   #
# # # # # #*# # # # # # #*# # #
#*   *s*    *** * x **        #
# # # # # # # # # # # # # #*# #
#    *  4  *        *    **  3#
# #*# # #*#*#*#*# # #1# # #*# #
#        *   *2*    *   *     #
#*# # # # # # # # # # #*# # #*#
# *    * **    ** ***     1   #
###############################



