10 13 16
################                  
#w     s*  *  ##
# # # #*#  #  ##
#  x*      b* ##
#   # # #  #  ##
#f  *  f      ##
#   # # #  #  ##
#*  b      *  ##
# # # # #*# # ##
#*    s*   *  ##
# #*# # # # # ##
#            q##
################


