5 13 31
###############################
#p * *3       *  ** * *      *#
# # # # #*# # #*# # # # # #*# #
#    * * *f* **  5   *    **  #
# #*# # # # # # #b#1# # # # #*#
#          *     **      *  **#
# # #*# # # # # #*#*#*#*# # # #
#   *      3 *   * *x* *   4  #
# # # # #*# # # # # # #*# #*# #
#   *s**         *2           #
# # # # # # # # # #b# # # # #*#
#  ** *5  *    2              #
###############################



